5,0,8,0,8,6,0,0,0,0,0,0
0,0,8,0,9,0,0,0,0,0,0,0
0,0,8,0,8,6,0,0,0,0,0,0
5,0,8,0,8,6,0,0,0,0,0,0
5,0,8,0,8,6,0,0,0,0,0,0
5,0,9,0,8,6,0,0,0,0,0,0
0,0,8,0,8,0,0,0,0,0,0,0
5,0,8,0,9,6,0,0,0,0,0,0
5,0,8,0,8,6,0,0,0,0,0,0
5,0,8,0,8,6,0,0,0,0,0,0
5,0,8,0,8,6,0,0,0,0,0,0
0,0,8,0,8,0,0,0,0,0,0,0
5,0,8,0,8,6,0,0,0,0,0,0
5,0,9,0,8,6,0,0,0,0,0,0
5,0,8,0,8,6,0,0,0,0,0,0
5,0,8,0,8,6,0,0,0,0,0,0
5,0,8,0,8,6,0,0,0,0,0,0
5,0,8,0,8,6,0,0,0,0,0,0
5,0,9,0,8,6,0,0,0,0,0,0
5,0,8,0,8,6,0,0,0,0,0,0
5,0,8,0,8,6,0,0,0,0,0,0
5,0,8,0,8,6,0,0,0,0,0,0
5,0,8,0,8,6,0,0,0,0,0,0
5,0,8,0,8,6,0,0,0,0,0,0
5,0,8,0,9,6,0,0,0,0,0,0
5,0,8,0,8,6,0,0,0,0,0,0
5,0,8,0,8,6,0,0,0,0,0,0
5,0,8,0,8,6,0,0,0,0,0,0
5,0,8,0,8,6,0,0,0,0,0,0
5,0,8,0,8,6,0,0,0,0,0,0
5,0,8,0,8,6,0,0,0,0,0,0
5,0,8,0,8,6,0,0,0,0,0,0
5,0,8,0,8,6,0,0,0,0,0,0
5,0,8,0,8,6,0,0,0,0,0,0
5,0,8,0,8,6,0,0,0,0,0,0
5,0,9,0,8,6,0,0,0,0,0,0
5,0,8,0,8,6,0,0,0,0,0,0
5,0,8,0,8,6,0,0,0,0,0,0
5,0,8,0,8,6,0,0,0,0,0,0
5,0,8,0,8,6,0,0,0,0,0,0
0,0,0,0,0,0,0,0,0,0,0,0
0,0,0,0,0,0,0,0,0,0,0,0
0,0,0,0,0,0,0,0,0,0,0,0
0,0,0,0,0,0,0,0,0,0,0,0
0,0,0,0,0,0,0,0,0,0,0,0
0,0,0,0,0,0,0,0,0,0,0,0
0,0,0,0,0,0,0,0,0,0,0,0
0,0,0,0,0,0,0,0,0,0,0,0
0,0,0,0,0,0,0,0,0,0,0,0
0,0,0,0,0,0,0,0,0,0,0,0
0,0,0,0,0,0,0,0,0,0,0,0
0,0,0,0,0,0,0,0,0,0,0,0
0,0,0,0,0,0,0,0,0,0,0,0
0,0,0,0,0,0,0,0,0,0,0,0
0,0,0,0,0,0,0,0,0,0,0,0
0,0,0,0,0,0,0,0,0,0,0,0
0,0,0,0,0,0,0,0,0,0,0,0
0,0,0,0,0,0,0,0,0,0,0,0
0,0,0,0,0,0,0,0,0,0,0,0
0,0,0,0,0,0,0,0,0,0,0,0
0,0,0,0,0,0,0,0,0,0,0,0
0,0,0,0,0,0,0,0,0,0,0,0
0,0,0,0,0,0,0,0,0,0,0,0
0,0,0,0,0,0,0,0,0,0,0,0
0,0,0,0,0,0,0,0,0,0,0,0
0,0,0,0,0,0,0,0,0,0,0,0
0,0,0,0,0,0,0,0,0,0,0,0
0,0,0,0,0,0,0,0,0,0,0,0
0,0,0,0,0,0,0,0,0,0,0,0
0,0,0,0,0,0,0,0,0,0,0,0
0,0,0,0,0,0,0,0,0,0,0,0
0,0,0,0,0,0,0,0,0,0,0,0
0,0,0,0,0,0,0,0,0,0,0,0
0,0,0,0,0,0,0,0,0,0,0,0
0,0,0,0,0,0,0,0,0,0,0,0
0,0,0,0,0,0,0,0,0,0,0,0
0,0,0,0,0,0,0,0,0,0,0,0
0,0,0,0,0,0,0,0,0,0,0,0
0,0,0,0,0,0,0,0,0,0,0,0
0,0,0,0,0,0,0,0,0,0,0,0
