1,2,2,2,2,4,0,0,0,0,0,0
1,3,3,3,2,4,0,0,0,0,0,0
1,2,3,3,2,4,0,0,0,0,0,0
1,3,3,2,2,4,0,0,0,0,0,0
1,3,2,3,2,4,0,0,0,0,0,0
1,2,2,3,3,4,0,0,0,0,0,0
1,2,2,3,2,4,0,0,0,0,0,0
1,3,3,3,3,4,0,0,0,0,0,0
1,3,3,3,3,4,0,0,0,0,0,0
1,3,3,3,3,4,0,0,0,0,0,0
1,3,3,3,3,4,0,0,0,0,0,0
1,2,2,3,2,4,0,0,0,0,0,0
1,2,3,2,3,4,0,0,0,0,0,0
1,2,2,3,2,4,0,0,0,0,0,0
1,2,3,3,3,4,0,0,0,0,0,0
1,3,2,3,2,4,0,0,0,0,0,0
1,2,2,2,2,4,0,0,0,0,0,0
1,2,2,2,2,4,0,0,0,0,0,0
1,2,2,2,2,4,0,0,0,0,0,0
1,2,2,2,2,4,0,0,0,0,0,0
1,2,2,3,2,4,0,0,0,0,0,0
1,2,3,2,2,4,0,0,0,0,0,0
1,2,2,3,2,4,0,0,0,0,0,0
1,2,2,2,2,4,0,0,0,0,0,0
1,2,2,2,2,4,0,0,0,0,0,0
1,2,3,3,2,4,0,0,0,0,0,0
1,2,3,2,2,4,0,0,0,0,0,0
1,2,2,2,2,4,0,0,0,0,0,0
1,2,2,2,2,4,0,0,0,0,0,0
1,2,2,2,2,4,0,0,0,0,0,0
1,2,2,2,2,4,0,0,0,0,0,0
1,2,3,2,2,4,0,0,0,0,0,0
1,2,2,3,2,4,0,0,0,0,0,0
1,2,3,2,2,4,0,0,0,0,0,0
1,3,2,3,2,4,0,0,0,0,0,0
1,2,3,2,2,4,0,0,0,0,0,0
1,2,2,3,2,4,0,0,0,0,0,0
1,2,3,2,2,4,0,0,0,0,0,0
1,2,2,2,2,4,0,0,0,0,0,0
1,2,2,2,2,4,0,0,0,0,0,0
0,0,0,0,0,0,0,0,0,0,0,0
0,0,0,0,0,0,0,0,0,0,0,0
0,0,0,0,0,0,0,0,0,0,0,0
0,0,0,0,0,0,0,0,0,0,0,0
0,0,0,0,0,0,0,0,0,0,0,0
0,0,0,0,0,0,0,0,0,0,0,0
0,0,0,0,0,0,0,0,0,0,0,0
0,0,0,0,0,0,0,0,0,0,0,0
0,0,0,0,0,0,0,0,0,0,0,0
0,0,0,0,0,0,0,0,0,0,0,0
0,0,0,0,0,0,0,0,0,0,0,0
0,0,0,0,0,0,0,0,0,0,0,0
0,0,0,0,0,0,0,0,0,0,0,0
0,0,0,0,0,0,0,0,0,0,0,0
0,0,0,0,0,0,0,0,0,0,0,0
0,0,0,0,0,0,0,0,0,0,0,0
0,0,0,0,0,0,0,0,0,0,0,0
0,0,0,0,0,0,0,0,0,0,0,0
0,0,0,0,0,0,0,0,0,0,0,0
0,0,0,0,0,0,0,0,0,0,0,0
0,0,0,0,0,0,0,0,0,0,0,0
0,0,0,0,0,0,0,0,0,0,0,0
0,0,0,0,0,0,0,0,0,0,0,0
0,0,0,0,0,0,0,0,0,0,0,0
0,0,0,0,0,0,0,0,0,0,0,0
0,0,0,0,0,0,0,0,0,0,0,0
0,0,0,0,0,0,0,0,0,0,0,0
0,0,0,0,0,0,0,0,0,0,0,0
0,0,0,0,0,0,0,0,0,0,0,0
0,0,0,0,0,0,0,0,0,0,0,0
0,0,0,0,0,0,0,0,0,0,0,0
0,0,0,0,0,0,0,0,0,0,0,0
0,0,0,0,0,0,0,0,0,0,0,0
0,0,0,0,0,0,0,0,0,0,0,0
0,0,0,0,0,0,0,0,0,0,0,0
0,0,0,0,0,0,0,0,0,0,0,0
0,0,0,0,0,0,0,0,0,0,0,0
0,0,0,0,0,0,0,0,0,0,0,0
0,0,0,0,0,0,0,0,0,0,0,0
0,0,0,0,0,0,0,0,0,0,0,0
